NO resources/textures/xpm/north_texture.xpm
SO resources/textures/xpm/south_texture.xpm
WE resources/textures/xpm/west_texture.xpm
EA resources/textures/xpm/east_texture.xpm
>>>>>>> origin/thiago

F 220,100,0
C 225,30,0

1111111111111111111111111
1000000000110000000000001
1011000001110000000000001
100100000000000000000000111111111
111111111111000001110000000000001
100000001011000001110111111111111
11110111101011011100000010001
11110111101011011101010010001
1111111111001011100000010001
1E000000010000011000000000011
111111111110000001101010010001
1111111111010101111101111000111
11110111111101011101111010001
11111111111111111111111111111
