NO resources/textures/xpm/wood.xpm
SO resources/textures/xpm/obsi.xpm              
WE resources/textures/xpm/netherrack.xpm
EA resources/textures/xpm/coble.xpm

C 255,255,255
F 34,139,34

1111111111111111111111111
1000000000110000000000001
1011000001110000000000001
100100000000000000000000111111111
111111111111000001110000000000001
10000000101000001110111111111111
11110111101011011100000010001111
11110111101011011101010010001
11111111110010111000000100011111
1000000010000011000000000011
11000000N00000000001010010001
110000000010101111101111000111
111100000111101011101111010001
11111111111111111111111111111
