 NO resources/textures/xpm/brick_wall.xpm

 SO resources/textures/xpm/south_texture.xpm

 WE resources/textures/xpm/west_texture.xpm

 EA resources/textures/xpm/east_texture.xpm

 F 220,100,0

 C 50,50,50
 
  111     111111 11111
  101     1E0000100011
  111   111111000000111111111111
        11111000001110000000111111
1111111111111111000000000000011111111
11111111100000000011100000011111
1000000000000011111000111000111111
1110001111000111000011000011100001
1100111000000111000011111000000001
1000000000000000000000000000000001              11111
1000000000000000000000000000000001               1001
1000000000000000000000000000000001                111
111111111111111111111111111111111
