                                                      NO textures/xpm/brick_wall.xpm

 SO textures/south_texture.xpm

 WE textures/weast_texture.xpm

 EA textures/east_texture.xpm

 F 220,100,0

 C 50,50,50
 
          11111111111
          1E0000000011
        111111000000111111111111
11111111100000000011100000011111
1000000000000011111000111000111111
1110001111000111000011000011100001
1100111000000111000011111000000001
1000000000000000000000000000000001
1000000000000000000000000000000001
1000000000000000000000000000000001
1111111111111111111111111111111111
